######S########
#......#.##...#
#.#..#.....##.#
#..#.#..#...#.#
#.....#..##...#
#.#.#.#.##.####
#.#.#...##....#
#..#.##....##.#
####.#.#.#..#.#
#.......#.#.#.#
#.#####...###.#
#......##..#..#
#.#..#..##..#.#
#.##..#...#...#
#######G#######
